CSU3 - STE-HYACINTHE
CYHU - SAINT-HUBERT
CYMX - MIRABEL
CYQB - QUÉBEC
CYUL - MONTREAL
CYVP - KUUJJUAQ
CYVR - VANCOUVER
CYYZ - TORONTO PEARSON
EDDF - FRANCFORT
EDDM - MUNICH
EGKK - LONDRES GATWICK
EGLL - LONDRES HEATHROW
EHAM - AMSTERDAM-SCHIPHOL
FACT - CAP TOWN AFRIQUE DU SUD
HECA - LE CAIRE
KATL - ATLANTA H.-JACKSON
KBOS - BOSTON
KCLT - CHARLOTTE DOUGLAS - CAROLINE DU NORD
KDEN - DENVER
KDFW - DALLAS-FORT WORTH
KEWR - NEWARK LIBERTY
KFLL - FT LAUDERDALE
KIAH - HOUSTON GEORGE BUSH
KJFK - NEW YORK-JFK
KLAS - HARRY REID LAS VEGAS
KLAX - LOS ANGELES
KMCO - ORLANDO
KMIA - MIAMI
KORD - CHICAGO O'HARE
KPHL - PHILADELPHIE
KPHX - PHOENIX SKY HARBOR
KSEA - SEATTLE-TACOMA
KSFO - SAN FRANCISCO
LDDU - DUBROVNIK CROATIE
LEBL - BARCELONE-EL PRAT
LEMD - MADRID-BARAJAS
LEZL - SEVILLE
LFML - MARSEILLE
LFMN - NICE
LFMV - AVIGNON
LFPG - PARIS-CHARLES-DE-GAULLE
LFRS - NANTES
LIMC - MILAN
LIRF - ROME
LIRP - PISE
LOWI - INNSBRUCK
LOWW - VIENNE
LPTT - LISBON
LTFM - ISTANBUL
MBPV - ILES TURKS AND CAIQUES
MDCY - SAMANA
MDPC - PUNTA CANA
MDSD - SANTO DOMINGO
MKJS - JAMAIQUE
MMCZ - COZUMEL
MMMX - MEXICO CITY
MMPR - PUERTO VALLARTA
MMUN - CANCUN
MMZH - IXTAPA
MUCC - CUBA CAYO COCO
MUCL - CUBA CAYO LARGO
MYEH - ELEUTHERA BAHAMAS
MYNN - NASSAU BAHAMAS
MZBZ - BELIZE CITY
NTAA - TAHITI
NTTB - BORA BORA
NTTE - TELIAROA
NTTH - HUAHINE
NTTH - HUAHINE–FARE
NTTM - MOOREA
NTTP - MAUPITI
NTTR - UTUROA
NZAA - NEW ZEALAND
OEJN - JEDDAH KING ABDULAZIZ
OMAA - ABU DHABI
OMDB - DUBAÏ
OTHH - DOHA HAMAD
RCTP - TAIPEI TAOYUAN
RJBB - OSAKA - KANSAI
RJTT - TOKYO HANEDA
RKSI - SEOUL INCHEON
RPLL - MANILA NINOY AQUINO
SBGL - RIO
SBRJ - RIO - SANTO DUMONT
SPJC - LIMA AIRPORT
SPZO - CUZCO
TAPA - ANTIGUA ANTILLES CARAIBES
TBPB - BARBADE
TDPD - DOMINIQUE CARAIBES
TFFF - MARTINIQUE
TFFR - GUADELOUPE
TIST - ILES VIERGES ST THOMAS
TISX - ST-CROIX ILES VIERGE CARAIBES
TJSJ - PORTO RICO
TKPK - ST KITS CARAIBES
TLPL - STE-LUCIE
TNCA - ARUBA CARAIBES
TNCB - BONAIRE CARAIBES
TNCC - CURACAO CARAIBES
TNCM - ST-MAARTEN PRINCESS JULIANA
TQPF - ANGUILLA CARAIBES
TTPP - TRINIDAD AND TOBAGO
TUPS - ILES VIERGE BRITANIQUE ROADTOWN
TXKF - BERMUDE
VABB - MUMBAI CHHATRAPATI SHIVAJI MAHARAJ
VHHH - HONG KONG
VIDP - DELHI INDIRA-GANDHI
VTBD - BANGKOK DON MUEANG
VTBS - BANGKOK SUVARNABHUMI
WIII - JAKARTA SOEKARNO-HATTA
WMKK - KUALA LUMPUR
WSSS - SINGAPOUR-CHANGI
YSSY - SYDNEY KINGSFORD-SMITH
ZBAA - BEIJING CAPITAL
ZGGG - CANTON-BAIYUN
ZGSZ - SHENZHEN BAO'AN
ZLXY - XI'AN XIANYANG
ZPPP - KUNMING CHANGSHUI
ZSPD - SHANGHAI PUDONG
ZSSS - SHANGHAI HONGQIAO
ZUCK - CHONGQING JIANGBEI
ZUUU - CHENGDU TIANFU